羣	群
脈	脉
貓	猫
峯	峰
廈	厦
蝨	虱
諡	謚
夠	够
豔	艷
灩	灧
戶	户
沒	没
歿	殁
彥	彦
顏	顔
朵	朶
垛	垜
挆	挅
趓	𧻞
躲	躱
剁	刴
跺	跥
搖	摇
遙	遥
瑤	瑶
即	卽
既	旣
唧	喞
溉	漑
概	槪
